MagnetoSensor	KEYWORD1
MagnetoSensorHmc	KEYWORD1
MagnetoSensorNull	KEYWORD1
MagnetoSensorQmc	KEYWORD1
begin	KEYWORD2
configureAddress	KEYWORD2
configureRange	KEYWORD2
configureOverSampling	KEYWORD2
configureRate	KEYWORD2
getGain	KEYWORD2
getNoiseRange	KEYWORD2
handlePowerOn	KEYWORD2
increaseRange	KEYWORD2
isOn	KEYWORD2
isReal	KEYWORD2
read	KEYWORD2
softReset	KEYWORD2
waitForPowerOff	KEYWORD2
testInRange	KEYWORD2
test	KEYWORD2
DefaultAddress	KEYWORD2
SensorData	KEYWORD1
reset	KEYWORD2
HmcRange	KEYWORD1
HmcRate	KEYWORD1
HmcOverSampling	KEYWORD1
HmcRegister	KEYWORD1
HmcBias	KEYWORD1
HmcMode	KEYWORD1
QmcRange	KEYWORD1
QmcRate	KEYWORD1
QmcOverSampling	KEYWORD1
QmcRegister	KEYWORD1
QmcMode	KEYWORD1
